const bookSolidArchivo = "book-solid.svg"
const bootstrapArchivo = "bootstrap.svg"
const brainSolidArchivo = "brain-solid.svg"
const briefcaseSolidArchivo = "briefcase-solid.svg"
const bugSolidArchivo = "bug-solid.svg"
const certificateSolidArchivo = "certificate-solid.svg"
const chalkboardUserSolidArchivo = "chalkboard-user-solid.svg"
const chevronDownSolidArchivo = "chevron-down-solid.svg"
const chevronUpSolidArchivo = "chevron-up-solid.svg"
const codeSolidArchivo = "code-solid.svg"
const commentDotsSolidArchivo = "comment-dots-solid.svg"
const commentsSolidArchivo = "comments-solid.svg"
const computerSolidArchivo = "computer-solid.svg"
const css3AltArchivo = "css3-alt.svg"
const databaseSolidArchivo = "database-solid.svg"
const fileExcelSolidArchivo = "file-excel-solid.svg"
const githubArchivo = "github.svg"
const globeSolidArchivo = "globe-solid.svg"
const handHoldingDollarSolidArchivo = "hand-holding-dollar-solid.svg"
const handHoldingHandSolidArchivo = "hand-holding-hand-solid.svg"
const houseSolidArchivo = "house-solid.svg"
const html5Archivo = "html5.svg"
const javaArchivo = "java.svg"
const linkedinArchivo = "linkedin.svg"
const listSolidArchivo = "list-solid.svg"
const paletteSolidArchivo = "palette-solid.svg"
const penToSquareSolidArchivo = "pen-to-square-solid.svg"
const pencilSolidArchivo = "pencil-solid.svg"
const phpArchivo = "php.svg"
const pythonArchivo = "python.svg"
const reactArchivo = "react.svg"
const rocketSolidArchivo = "rocket-solid.svg"
const screwdriverWrenchSolidArchivo = "screwdriver-wrench-solid.svg"
const squareJsArchivo = "square-js.svg"
const userSolidArchivo = "user-solid.svg"
const usersSolidArchivo = "users-solid.svg"
